R 1520 1520
WE ./texture/masked.xpm
EA ./texture/rolling_stones.xpm
NO  ./texture/rl_stones.xpm
SO ./texture/yoda.xpm
S ./texture/barrel.xpm
F 40,40,40
C 0,179,179


        1111111111111111111111111
        1000000000110000000000001
        1011000001110000002020001
        1001000000000000000000001
111111111011000001110000000200001
100000000011000001110111111111111
11110111111111011100000010001
11110111111111011101010010001
11000000110101011100000010001
10002000S00000001100002000001
10000000000000001101010010001
1100000111010101111101111000111
11110111 1110101 101111010001
11111111 1111111 111111111111
