R 1920 1024

WE ./texture/rolling_stones.xpm
EA ./texture/yoda.xpm
NO  ./texture/island_stone.xpm
SO ./texture/rl_stones.xpm
S ./texture/barrel.xpm
F 51,51,51
C 0,179,179

        1111111111111111111111111
        1000000000110000000000001
        1011000001110000002020001
        1001000000000000000000001
111111111011000001110000000200001
100000000011000001110111111111111
11110111111111011100000010001
11110111111111011101010010001
11000000110101011100000010001
10002000000000001100002000001
10000000000000001101010010001
11000001110101011111011110N0111
11110111 1110101 101111010001
11111111 1111111 111111111111