R 1000 800
NO ./texture/masked.xpm
SO ./texture/masked.xpm
WE ./texture/masked.xpm
EA ./texture/masked.xpm
S ./texture/barrel.xpm
F 26,26,18
C 26,21,21
        1111111111111111111111111
        1000000000110000000020001
        1011000001110000000000001
        1001000000000000000020001
111111111011000001110000000000001
100000000011000001110111111111111
11110111111111011100000010001
11110111111111011101010010001
11000000110101011100000000201
10000000000000001102000000001
10000000000000001101010000001
11000001110101011111011100N0111
11110111 1110101 101111000001
11111111 1111111 111111111111
