R  1200  1200

NO ./texture/masked.xpm
SO ./texture/masked.xpm
WE ./texture/masked.xpm
EA ./texture/masked.xpm
S ./texture/barrel.xpm



F  50,50,50
C  116,185,200

111111111111111111111111111111111111111
100000000010000000000000000000000000001
101100000110000000000000000000000000001
100100000000000000000000000000000000001
101100000110000000000000000000000000001
100000000010000001110111000000000000001
111101111110110111000000000000000000001
111101111110110111010100100000000000001
110000001100010111000000100000000000001
100000000000010011000000000000000000001
100000000000010011010100100000000000001
110000000000010111110111100000000000001
1111011111100101111100000000000000E0001
111111111111111111111111111111111111111